m m m m m m m m m m m m m m m m m m m m m m m m m m m m m m m m m m m m m m m m  
m p x x x x x b b b x x x x x x x x x x x x x x x x b b m gs x x x x x b b b b m  
m m m m m x m b b b x x x m x x x x x x x x x x x x x b m x x x x x x x b b b m  
m s b b m x m b b b m x x m x x m m m m m m m x x x x x x x m m m m m m x b b m  
m b b b m x m b b b m x x m b b m b b b x gd m m m m m x m m m b b b x m x x b m  
m b b b m x m m m m m x x m b b m b b b x x x x b b m b b b m b b x x m x x x m  
m b b b m x x x x x x x x m m m m b b b x x x x x b m m m b m b x x x m m m x m  
m x x x m x x x x x x x x x x m b b b b x x x x x x m b b b m x x x x x x x s m
m x x x m x x x m m m m x x x m m m m m m m m m m x m x m m m m x m m m m m m m  
m x x x x x m x x b b m x x x m s m b x x x x x x x m x x x x x x x x m b x gs m  
m x x x x b m x x b b m x x x m b m x x x x x m m m m x x x x x x x x m b x x m  
m x x m m m m x x x x m x x x m b m x x x x x m gs x x x x b m m m x x m b x x m  
m x x x gd x x x x x x x x x x m b m x m m x x m x x x x x b m b m b b m b x x m  
m gd x x x x x x x m b x x x x x x x x x m x x m x x x x x b m b m m m m b x x m  
m m m m x m x x x m b b x x x x x x x x x x x m x x x x x b m b b b b b b x x m  
m b b x x m b b m m m m m m x x x m m m m m b m b m m m m x x x x x x x x x x m  
m b b x x m b b m x x x x x x m x x x b b m b m b m b b m m m m x x m x x x b m   
m x x x m m m m m x x x x x x m x x x b b m b m b m x x x b b m x x m x x b b m  
m x x x m b b x x x x x x m b m b m x x x m b b b m x x x b b m x x m m m m m m  
m x x x m b x x x x x m m m m m m m x x x m m m m m x x x m m m x x x x x b b m  
m x x x m x x x m x x x x b m b b m m x x b b m b b x x x m b b x x x x x x b m  
m x x x m x x x m x x x x x m b b x m x x x x m x m x x x m m m m m m m m x x m  
m x x x x x m m m m m x x x m x x x m m m x x x x m x x x x x x x x b x x x x m  
m x x x x x b b m b b x x x x x x x x m m x x m x m x x x x x x x x b x x x x m  
m x x x x b b b m b b x m m x x x x x x x x x m x x x x x m m m m m m m m x gd m  
m x x x m m m m m m m m m m x x x x x x x x x m x x x x x x m b b b s m x x x m  
m b x x x x x gs m x x x x x x x m m m m m m m m x x m x x x m b b b b m x x x m  
m b b x x x x x m x x m x x x x b b m b b b x x x x m m m m m x x x x m x b b m  
m b b b x x x x x x x m x x x x b b m b b b x x x x x x x x x x x x x m b b b m  
m m m m m m m m m m m m m m m m m m m m m m m m m m m m m m m m m m m m m m m m 