m m m m m
m p x x m
m x x x m
m x x x m
m m m m m