m m m m m m m m m m m m m m m m m m m m m m m m m m m m m m m m m m m m m m m m  
m m m m m m x x x x x x x x x x x x x x x x x x x x x x x x x x x x x x x x x m  
m m p x x m x x m m m m m m m x x x x x x x x x x x x x x x x x x x x x x x x m  
m m x x x x x x x x x x x x m x m m m m m m m m m m m m x x x x x x x x x x x m  
m m x x x x x x x x x x x x m x m b b x x x x b b b b m x x x x m m m m m x x m  
m m m x x m m m m m m m x x m x m b b x x x x gd b b b m x x x x m b b b m x x m  
m x x x x m b b b b x m x x m b m m m x x x x b b b b m x x x x m b s b m x x m  
m x x x x m b b b x x m x x m b b s m x x x m m m m m m x x x x m b b b m x x m  
m x x x x m b b gd x x m x x m m m m m x x x m b b b b x x x b b m x x x m x x m  
m x x x x m b x x x x x x x x x x x x x x x m b b b b x gs x b b m x x x m x x m  
m x x x x m x x x x x x b b x x x x x x x x m b b b b x x x m m m x x x m x x m  
m x x x x m m m m x x b b b b x x m m x x x m b b b b x x x m x x x x x m x x m  
m x x x x x x x x x x x b b x x x b m x x x m m m m m m m m m x x x x x m x x m  
m x m x x x x x x x x x x x x x b b m x x x x x x x x x x x x x gd x x x m x x m  
m x m x x x x x x x x x x x m b b b m x x x x x x x x x x x x x x x x x m x x m  
m x m x x x x m m m m x x x m m m m m m m m m m m x x x x x x x x x x x m m x m  
m x m m m x x m b b m x gs x x x x x m b b b b b m x x x m m m m m m b b b m x m  
m x x s m b b m b b m x x x x x x x m b b b b x m x x x m b b x x m b b s m x m  
m x x x m b b m x x m x x x m m m x m b b b x x m x s x m b b x x m m m m m x m  
m x x x m m m m x x m x x x m s m x m b b x x x x x x x x x x x x x x x x x x m  
m x x x x x x x x x m x x x m x m x m b x x x x x b b x x x x x x x x x x x x m  
m x x x x x x x x x m x x x m x m x m m m m x x b b b b x x m m m m m m m x x m  
m x x x x x x x b b m x x x m x x x x x x x x x x b b x x x m b b b b b m x x m  
m x x x x x x m m m m x x x m m x m x x x x x x x x x x x x m b b b b b m x x m  
m x x x x x x m b b b x x b b m x m x x x x x x x x x x x x m b b b b b m x x m  
m x x x gd x x m b b b x x b b m x m m m m x x x x x x x x x m b b b x x m x x m  
m x x x x x x m m m m m m m m m x x x x m m m m m m m m m x m b b x x x x x x m  
m x x x x x x x x x x x x x x x x x x x x x x x x x x x x x m m m m m x b x x m  
m x x x x x x x x x x x x x x x x x x x x x x x x x x x x x x x x x x x x x s m  
m m m m m m m m m m m m m m m m m m m m m m m m m m m m m m m m m m m m m m m m 